年度,月份,總計,０~４歲,５~９歲,１０~１４歲,１５~１９歲,２０～２４歲,２５～２９歲,３０～３４歲,３５～３９歲,４０～４４歲,４５～４９歲,５０～５４歲,５５～５９歲,６０～６４歲,６５～６９歲,７０～７４歲,７５～７９歲,８０～８４歲,８５～８９歲,９０～９４歲,９５～９９歲,100歲以上
106,1,8397,364,209,291,398,516,524,630,633,608,615,713,648,584,509,308,304,298,171,58,15,1
106,2,8393,359,210,293,394,513,524,624,636,599,630,709,649,584,515,303,302,300,174,59,15,1
106,3,8389,353,219,283,397,509,530,617,635,602,636,707,643,585,517,304,307,297,174,59,14,1
106,4,8376,349,211,277,395,511,532,614,641,603,635,699,647,586,519,304,305,297,175,61,14,1
106,5,8378,352,218,273,395,512,526,610,642,602,638,687,652,594,518,305,307,298,172,61,15,1
106,6,8395,352,225,271,393,516,529,612,642,603,629,693,656,597,516,308,306,297,174,59,16,1
106,7,8411,363,220,276,387,518,529,611,650,602,619,699,652,606,521,305,308,294,174,60,16,1
106,8,8409,362,222,277,380,515,533,605,649,608,615,705,646,607,529,301,309,295,177,57,16,1
106,9,8406,359,223,271,371,527,528,601,645,606,621,705,651,606,531,305,302,302,176,59,16,1
